wonder | v.对…感到疑惑（或好奇），想知道；（对…）感到惊讶（或诧异）n.惊奇，惊异；奇迹，奇事
electric | adj.电动的，电的
what | pron.什么；多么，何等…的事物
tie | v.栓，扎，捆；把…打结，系上；连接，使有关联；不分胜负
both | adj.两个…（都）pron.两者（都），双方（都）
lazy | adj.懒惰的，懒散的；满吞吞的
rocket | n.火箭v.迅速上升；猛涨
ocean | n.洋，海洋；许多，大量
real | adj.真的，真正的；真实的，现实的
helicopter | n.直升机
appointment | n.约会；约定；任命，委派；职务，职位
speak | v.说话，讲话；演说，发言；表达意见；说（出），讲（出）；(会)讲（某种语言）
begin | v.开始
Tuesday | n.星期二
announce | v.宣布，声称；预告
England | n.英格兰，英国
whether | conj.是否，会不会；不管，无论
tennis | n.网球
ice | n.冰，冰块v.使变凉，冰冻，冰镇adj.冰的
plan | n.计划，打算，规划；平面图，示意图；设计图
Brazilian | n.巴西人adj.巴西的；巴西人的
height | n.高，高度；高处，高地；顶点
clear | adj.清楚的，明白的；无疑的，确信的；晴朗的；清澈的adv.清晰地，清楚地v.扫清，清楚；使清楚，使明白；使清白无辜，证明…无罪；变晴；变清澈
symphony | n.交响乐，交响曲；（色彩等的）和谐，协调
century | n.世纪，百年
spare | adj.备用的；多余的；空闲的v.留出，抽出（时间）；饶恕，不伤害；使免遭，免去；节约，吝惜n.备用品；备用轮胎
difficult | adj.困难的；难懂的；难以取悦的
festival | n.节，节日，喜庆日
chest | n.胸，胸膛；柜子，橱
gentle | adj.温柔的，慈祥的；文雅的，有礼貌的；（指天气、温度等）温和的，暖和的
home | n.家乡；家，家庭；原产地，发源地adj.家庭的；家用的；国内的adv.回家，在家；在本国，回本国
injure | v.伤害，损害，损伤
behave | v.表现；表现得体，有礼貌；（机器等）运转；起作用
spoken | adj.口头的，口语的
medical | adj.医学的，医疗的
hamburger | n.汉堡包
anyone | pron.任何人；随便哪一个人
after | adv./prep./conj.在…以后，在…后面
enough | adv.足够地，充分地；相当，达到一定的程度adj.足够的
common | adj.共同的；平常的，普通的；共有的，公有的
he | pron.他；（不论性别的）一个人
his | pron.他的（所有物）
establish | v.建立，设立；确定，证实
shock | n.震动，冲击；震惊，惊愕；电震，电击，触电v.(使)震动；（使）休克
disease | n.疾病，病患；不健全，弊端
need | v.需要；必须v.aux.必要，必须n.需要，必要；缺乏；迫切要求
last | adj.刚过去的，紧接前面的；最后剩下的；最不可能的，最不合适的；最终的，结论性的adv.上一次，最近一次；最后一次；最后v.持续，维持
rank | n.等级；军衔，职衔v.排列，使排成行；讲…分等级；属于谋等级，居某地位
drink | n.饮料；酒v.饮，喝（酒等）
seventy | num.七十，七十个
number | n.数目，数字；号码，编号v.给…编号
progress | n.前进；进步；进展v.前进，进行
town | n.镇，市镇；市区，市中心
stair | n.楼梯；（楼梯的）梯级
light | n.光，光亮；光源，灯；（火柴、打火机等的）adj.光线充足的，明亮的；淡色的，浅色的；轻的，少量的；愉快的，轻快的；（食物）清淡的，不油腻的v.点，点燃；照亮；使发光
yard | n.院子，场地；码
