mean | v.[meant-meant]表示…的意思；意欲，打算；意指，意味着 adj.卑鄙的，卑贱的；吝啬的；恶意的
sign | n.标志，符号；招牌；征兆，迹象 v.签（名）；签署
minute | n.分，分钟；一会儿，片刻；此时此刻，立刻
require | v.需要；需求，命令；规定
unless | conj.除非，如果不
allow | v.允许，准许，容许；允许…进入（或停留）；同意给；承认
discover | v.发现，发觉
Australia | n.澳大利亚
stage | n.舞台，后台；平台，高台；楼层，楼架
player | n.选手，队员；做游戏的人；演员；演奏者；播放器
student | n.学生，学者，大学生；研究生
popularity | n.普及；流行
pay | v.付钱，支付，交纳 n.工资，薪金
toast | n.烤面包，吐司；祝酒，祝酒词 v.烘，烤；敬酒，为…干杯
beach | n.海滩，沙滩
retire | v.退休，退役；退下，退出；退却，撤退；就寝
believe | v.相信；认为
stick | n.棍，棒，手杖 v.[stuck-stuck]刺，戳，插；粘贴，粘住，钉住；被粘住，被钉住，卡住；留下，长久保留
chore | n.家庭杂务；困难的工作；令人厌烦的工作
realistic | adj.现实的；现实主义的；逼真的
hair | n.头发，毛发
each | pron.∕adv.各个，每个
fork | n.叉，餐叉；耙；分叉，岔口
wheat | n.小麦；淡黄色；朴实的人
shame | n.羞耻，羞愧；可耻的人（或事物）；遗憾的事，可惜 v.使蒙受羞辱
lookout | n.警戒，监视；瞭望台，监视哨；瞭望员，监视者；与个人有关的事情，任务
prevent | v.阻止，妨碍
singular | adj.单数的；单一的
land | n.陆地，地面；土地，田地；国家，国土 v.（使）靠岸，（使）登陆；（使）降落
seek | v.[sought-sought]寻找，追求；征求（意见），请求（帮助）；试图，设法；探索
introduce | v.介绍；引进，传入；提出（议案等）供讨论；采用
lock | v.锁上；卡住 n.锁；船闸
return | v.返回，回来；回复，回应；退回；回报 .返回，回来；偿还，归还；恢复；回报；收益，盈利；申报（表），（统计）报表；往返票 adj.往返的，返回的
fan | n.扇子；扇形物；狂热爱好者，迷 v.煽动，激起
popular | adj.流行的，通俗的，大众的；受欢迎的
aunt | n.姑姑，姨妈，伯母，婶婶，舅妈
tiny | adj.极小的，微小的
rest | n.剩余部分，其余的人（或物）；休息；停止，静止；撑架，支座 v.休息，睡眠；放，靠；取决于；依靠，依赖；停留 adj.其余的
half | adj.一半的，半个的 n.半，一半 adv.一半
gym | n.健身房；体育馆
misleading | adj.令人误解的，导致错误结论的；引入歧途的；欺骗的；迷惑的
barbecue | n.烧烤野餐；金属烤架 v.在烤架上烧烤
complete | adj.十足的，彻底的；完成的 v.完成，结束
hole | n.洞，孔眼；漏洞，缺陷
earth | n.地球；陆地，地面；土，泥
sorry | adj.对不起的，抱歉的；遗憾的，惋惜的；可怜的，使人伤心的
be | v.是，就是；在，存在
aggressive | adj.侵犯的，侵略的，挑衅的；敢做敢为的，有进取心的
flag | n.旗，旗帜；标识
later | adv.后来；过一会儿 adj.后来的，后面的；新进的；晚年的
wonderful | adj.极好的；惊人的，奇妙的
therefore | adv.因此，所以
eye | n.眼，眼睛；虹膜；眼状物
moon | n.月球，月亮；卫星
Mr. | n.先生
forbid | v.[forbade-forbiddden]不许，禁止；妨碍，阻止
seldom | adv.很少，不常
