toss | n. 掷钱币来决定，猛抬头 vt. 扔，抛，掷；猛抬（头）；拌（食品）；（打赌等时）掷（钱币）；使摇动，使颠簸 vi. 掷钱币来决定；翻来覆去【考】toss up （打赌等时）掷（钱币）
blossom | n.（尤指果树的）花 vi.（植物）开花；发展，长成【考】in (full) blossom 正开着花；blossom out
hospitality | n.（对客人的）友好款待，好客
tow | n.拖拉，牵引
discrete | adj. 分离的，不相关联的
soluble | adj. 可溶的；可解决的
foil | n. 箔，金属薄片；陪衬，衬托 vt. 挫败，使受挫折
slippery | adj. 滑的；狡猾的
stock | n. 原料；库存品；股本，公债；世系，血统；汤汁；［总称］家畜，牲畜 v. 储备 adj. 常用的，常备的【考】out of stock 脱销
cavity | n. 洞，穴；凹处；龋洞
loyal | adj. 忠诚的，忠心的【考】be loyal to 忠诚于…
toxic | adj. 有毒的；因中毒引起的
epidemic | n. 流行病；流传，盛行 adj. 流行性的，流传极广的
anonymous | adj. 无名的，不具名的；匿名的；无特色的，无个性特征的
coverage | n. 新闻报道；覆盖范围
tract | n. 传单，小册子；大片（土地或森林）
hatch | n.（飞机等的）舱门；（门等的）开口；孵化 vt. 孵出，孵；筹划，图谋，策划 vi.（小鸡等）出壳【考】hatch out （小鸡等）孵出
management | n. 管理；处理；管理部门，管理人员
cling | vi. 紧紧抓住（或抱住）；黏着，挨近；依附，依恋；坚持，墨守，忠实于【考】cling to 紧紧抓住（或抱住）
panic | n. 恐慌，惊慌，慌乱 v.（使）恐慌，（使）惊慌失措
trademark | n. 商标，牌号；特征，标记
opponent | n. 对手，敌手，对抗者
indignation | n. 愤怒，愤慨，义愤
guarantee | n. 保证；担保物 vt. 保证，担保
tragic | adj. 悲惨的，可悲的；悲剧（性）的
controversial | adj. 引起争论的，有争议的
trait | n. 特征，特点，特性
demonstrate | vt. 说明，论证；表露
abolish | vt. 彻底废除，废止
possess | vt. 占用，拥有
deduct | vt. 扣除，减去
cast | n. 演员表，全体演员；石膏绷带；铸型，铸件；投，抛 vt. 扔；浇铸
Easter | n.（基督教）复活节
intermittent | adj. 间歇的，断断续续的
specific | n. 详情，细节 adj. 特有的，明确的
oppose | vt. 反对，反抗
extract | vt. 取出，抽出，拔出；提取，提炼，榨取；获得，索取；摘录，抄录 n. 摘录，选段；提取物
commonwealth | n. 英联邦，联合体
transaction | n. 交易；业务
cabinet | n. 橱，柜；内阁
ornament | n. 装饰品，点缀品 vt. 装饰，点缀，美化
norm | n. 标准，规范；
contribute | v. 捐献，捐款；投稿【考】contribute to 捐献
reckon | vt. 认为，估计；指望，盼望；测算，测量
considerate | adj. 考虑周到的，体贴的，体谅的
ceramic | n. 陶瓷器
digest | vt. 消化；领会 n. 文摘
transcend | vt. 超出，超越（经验、理性、信念等的）范围
extravagant | adj. 奢侈的；过度的，过分的，（言行等）放肆的
reproach | n./vt 责备，批评
transfer | v. 搬，转移；调动，转学；转让，过户；乘车，转乘
retention | n. 保留，保持
snack | n. 快餐，小吃，点心
transform | vt. 使改观，使改革；变换，把…转换成
notation | n. 记号，标记法
flap | n. 片状垂悬物（信封的口盖、衣服的袋盖等）；飘动，摆动；（翅的）振动；激动，慌忙状态 vt. 使拍动，使飘动 vi. 拍动；（鸟）振翅（飞行）
transient | adj. 短暂的，转瞬即逝的；临时的，暂住的
specification | n. 规格，规范，说明书
attempt | vt. 尝试，试图；努力
memorize | v. 记住，熟记
inhibit | vt. 阻止，妨碍；抑制
carve | vt. 切，把…切碎（或切成片）；雕刻，刻【考】carveout 创（业），发（财）；carve up 分割，瓜分
empirical | adj. 以经验（或观察）为依据的；经验主义的，经验的
relay | n. 接力赛；中继转播（设备） vt. 传送；传达，转述；中继转播
install | vt. 安装，设置；使就职，任命
cereal | n. 加工而成的谷类食物；谷类植物，谷物
ignore | vt. 不顾，不理；忽视
catastrophe | n. 大灾难，灾祸
float | v.（使）浮动，（使）漂浮；（使）飘动
transistor | n. 晶体管，晶体管收音机
metallic | adj. 金属的，金属制的；有金属特性的，像金属的
transit | n. 运输，载运【考】in transit 在运输中，在途中
involve | vt. 使卷入，牵涉；包含，含有
specialty | n. 特产，名产；特色菜；专业，专长
brilliant | adj. 光辉的；卓越的
expend | vt. 花费，消费；消耗
prosecute | vt. 对…提起公诉，告发，检举；继续从事 vi. 起诉，告发
transition | n. 过渡，转变
casualty | n. 伤亡人员，死伤者；受害人，损失的东西
permeate | v. 弥漫，遍布，散布；渗入，渗透
inhabitant | n. 居民，住户
pendulum | n. 摆，钟摆；摇摆不定的事态（或局面）
doom | n. 厄运，劫数 vt. 注定，命定
fixture | n. 固定装置
refund | n. 退款 vt. 退还（钱款）
linger | vi.（因不愿离开而）继续逗留，留恋徘徊；继续存留，缓慢消失【考】linger on 继续存留
converge | vi.（在一点上）会合，互相靠拢；聚集，集中；（思想、观点等）十分相似，相同
incentive | n. 刺激，鼓励
associate | n. 伙伴，同事 v.（在思想上）把…联系在一起；使联合，结合；交往 adj. 副的【考】associate with 结交，交往
royalty | n. 王族（成员）；
dentist | n. 牙科医生
pursue | vt. 继续；从事；追赶，追踪；追求
literary | adj. 文学（上）的；文人的，书卷气的
overwhelm | vt.（感情上）使受不了，使不知所措；征服，制服
transmit | vt. 传送，传递，传染；播送，发射
disgust | n./vt.厌恶，憎恶
force | n. 兵力，暴力
mock | v. 嘲笑，嘲弄；（为了取笑）模仿 adj. 模拟的，演习的；假的，假装的
aviation | n. 航空，航空学；飞机制造业
classic | n. 文学名著，经典作品，杰作；优秀的典范；
reliable | adj. 可靠的，可依赖的
fling | n. 尽情欢乐的一阵，一时的放纵 vt.（用力地）扔，掷，丢；使扑，使投身
figure | n. 数字；人物；
anticipate | vt. 预料，预期，期望；先于…行动，提前使用
genetic | n. 遗传学
rupture | n. 破裂，断裂；（关系的）决裂，断绝 v.（使）破裂
reliance | n. 依靠，依赖
literature | n. 文学，文学作品，文献，图书资料
gleam | n. 闪光，闪亮；闪现，流露 vi. 闪烁【考】gleam with 流露
salvation | n. 拯救，解救；解救措施
redundant | adj. 多余的，过剩的
portray | vt. 描写，描绘；扮演，饰演
intensive | adj. 加强的；精耕细作的
transplant | n.（器官）移植 vt. 移栽，移种（植物等）；移植（器官）；使迁移，使移居
reconciliation | n. 和解，调和
transport | n. 运输，运输工具
enforce | vt. 实施，执行；强制，强迫，迫使
coalition | n. 结合体，同盟；结合，联合
accuse | vt. 指责，归咎于【考】accuse sb. of doing sth. 指控某人做某事…
traverse | vt. 横渡，横越
sergeant | n. 中士，警官
rating | n. 等级，品级，评定结果；
treaty | n. 条约，协议，协定
compartment | n. 卧车包房，（客车车厢内的）隔间；分隔的空间
blunder | n.（因无知、粗心等造成的）错误 vi. 跌跌撞撞地走，慌乱地走；犯错误
fuel | n. 燃料，燃料剂 vt. 给…加燃料；刺激
grain | n. 谷物，谷粒，颗粒；少量，微量
authority | n.官方，权利
regiment | n.（军队的）团；大量 vt. 严格管制，严密编组
liner | n. 衬里；大客轮
tremendous | adj. 极大的，非常的；精彩的，了不起的
resent | vt. 对…表示忿恨，怨恨
afflict | vt. 使苦恼，折磨
recession | n.（经济的）衰退，衰退期【考】economic recession 经济衰退
drag | n. 累赘；一吸，一抽 v. 拖，拉；迫使，硬拉；拖着脚步走【考】drag on
annual | n. 年报，年鉴；一年生的植物 adj. 每年的，一年一次的
given | adj. 规定的，特定的；假设的，已知的；有癖好的，有倾向的 prep. 考虑到
indulge | vt. 使（自己）沉溺于，满足（自己的欲望等）；纵容，迁就 vi. 沉溺，纵容自己，肆意从事【考】indulge in 沉溺，肆意从事
electronic | n. 电子学，电子设备
trench | n. 沟，沟渠
recruit | n. 新兵 vt. 招募（新兵），吸收（新成员）
trend | n. 倾向 vi. 伸向
trial | n. 试，试验；审判；讨厌的人（或事物）
defy | v.（公然）违抗，蔑视；使成为不可能；挑，激
tribe | n. 部落；族（生物分类）
fragile | adj. 易碎的，脆的，易损坏的；虚弱的，脆弱的
quest | n. 寻找，搜索；追求
tribute | n. 颂词，称赞；（表示敬意的）礼物；贡品
revolve | vi. 旋转【考】revolve around 以…为中心
