virus | n.[微]病毒,滤过性微生物,毒害,恶毒(vires[5vaiEri:z]n.活力)
visible | adj.看得见的,明显的,显著的;n.可见物
vision | n.视力,视觉,先见之明,眼力,想象力,幻想,幻影,景象;vt.梦见,想象,显示
visual | adj.看的,视觉的,形象的,栩栩如生的
vital | adj.生死攸关的,重大的,生命的,生机的,至关重要的,所必需的
vitamin | n.维他命,维生素
vivid | adj.生动的,鲜明的,鲜艳的,大胆的,清晰的,活泼的,逼真的
vocabulary | n.词汇,词汇量,词表
volcano | n.火山
volt | n.(马术中的)环骑,[击剑]闪避,[电工]伏特
voltage | n.[电工]电压,伏特数
volume | n.卷,册,体积,量,大量,音量
voluntary | adj.自动的,自愿的,主动的,故意的,非官办的,志愿的,自发的
volunteer | n.志愿者,志愿兵;adj.志愿的,义务的,无偿的;v.自愿
vote | n.投票,选票,表决,得票数;vi.投票;vt.投票,投票决定,公认,<口>建议,使投票
wagon | n.四轮马车,货车;v.用马车运输货物
waist | n.腰部,腰,衣服的上身部分,背心
waken | vi.醒来;vt.唤醒
wander | vi.漫步,徘徊,迷路,迷失方向,离题
warmth | n.暖和,温暖,热心,热情
waterproof | adj.防水的,不透水的
wax | n.蜡,蜡状物,增加,月亮由亏转盈;vi.变大,增大,月亮渐满;vt.上蜡于
weaken | v.削弱,(使)变弱
wealth | n.财富,财产,大量
wealthy | adj.富有的,丰裕的,充分的;n.富人,有钱人
weapon | n.武器
weave | n.编法,织法,编织;vt.编织,组合,编排,使迂回前进;vi.纺织,迂回行进,摇晃;n.织法,织物
weed | n.野草,杂草;v.除草,铲除
weekly | adj.每星期的,一周的;adv.每周一次;n.周刊,周报
weep | n.哭,哭泣,滴下;vi.哭泣,流泪,哀悼,滴落;vt.哭着使...,悲叹,滴下
weld | vt.焊接;n.焊接,焊缝
welfare | n.福利,安宁,幸福,福利事业,社会安全;adj.福利的
well-known | adj.众所周知的,有名的,清楚明白的
whale | n.鲸;v.捕鲸
whatsoever | pron.任何，无论什么（用于否定句中以加强语气）
whereas | conj.然而,反之,鉴于,尽管,但是
whichever | pron.无论那一个,任何一个
whilst | conj.时时,同时（与while同义）
whip | n.鞭子,车夫;v.鞭打,抽打,突然移动
whisper | n.耳语,私语,密谈,谣传,飒飒的声音;vi.耳语,密谈,飒飒地响;vt.低声说
whistle | n.口哨,汽笛,口哨声,汽笛声;v.吹口哨,鸣汽笛
whoever | pron.任何人,无论谁
wholly | adv.整个,统统,全部,专门地
wicked | adj.坏的,邪恶的,缺德的,不道德的,恶劣的,刻毒的,淘气的(wick[wik]n.蜡烛心,灯芯,油绳v.通过毛细作用带走)
widen | v.加宽,放宽,扩展
widespread | adj.分布广泛的,普遍的
widow | n.寡妇;v.使成寡妇(或鳏夫)
width | n.宽度,宽广,广博,有一定宽度的东西(如一快布料等)
wisdom | n.智慧,明智的行为,学识,名言,贤人,至理名言
wit | n.智力,才智,智慧
withdraw | vt.收回,撤消;vi.缩回,退出;v.撤退
withstand | vt.抵挡,经受住
witness | n.[律]证人,目击者,证据,证明,证词;vt.目击,为...作证,证明,表明;vi.作证,成为证据
wolf | n.狼,残忍贪婪之人,极度的穷困;vt.狼吞虎咽,大吃;vi.猎狼
wool | n.羊毛,毛织品,毛线,绒线,毛料衣物
workman | n.工人,工匠,男工
workshop | n.车间,工场
world-wide | adj.全世界的
worm | n.虫,蠕虫,蚯蚓,蜗杆,螺纹,小人物;vi.蠕行,慢慢前进;vt.使蠕行,慢慢地走,给(烟草作物)除虫
worship | n.崇拜,礼拜,尊敬;vi.敬神,拜神;vt.崇拜,尊敬
worthless | adj.无价值的,无益的
worthwhile | adj.值得做的,值得出力的
worthy | n.杰出人物,知名人士;adj.有价值的,应...的,可敬的,值得的,相称的
wrap | n.外套,围巾,包裹,秘密,约束,限制;vt.包装,卷,缠绕,包,覆盖,裹,遮蔽,隐藏;vi.缠绕,重叠,穿外衣,包起来
wreck | n.失事船(或飞机),残骸,(船,飞机的)失事;vt.破坏,拆毁
wardrobe | n.衣柜,衣厨,衣室,衣服,行头,剧装
warfare | n.战争,作战,冲突,竞争
